12,12,12,12,12,4,4,5,-1,-1,-1,-1,-1,-1,-1,-1,-1,-1,-1,-1,-1,-1,-1,-1,-1,-1,-1,-1,-1,-1,-1,-1,-1,-1,-1,-1,-1,-1,-1,-1,-1,-1,-1,-1,-1,-1,-1,-1,-1,-1,12,12,12,12,-1,-1,12,12,12,-1,-1,-1,-1,-1,-1,-1,-1,-1,-1,-1,-1,-1,-1,-1,-1,-1,-1,-1,-1,-1,-1,-1,-1,-1,-1,-1,-1,-1,-1,-1,-1,-1,-1,-1,-1,-1,-1,-1,-1,-1,-1,-1,-1,-1,-1,-1,-1,-1,-1,-1,-1,-1,-1,-1,-1,-1,-1,-1,-1,-1,-1,-1,-1,-1,-1,-1,-1,-1,-1,-1,-1,-1,-1,-1,-1,-1,-1,-1,-1,3,4,4,4,4,4,4,4,5,-1,-1
12,12,12,12,12,4,4,5,-1,-1,-1,-1,-1,-1,-1,-1,-1,-1,-1,-1,-1,-1,-1,-1,-1,-1,-1,-1,-1,-1,-1,-1,-1,-1,-1,-1,-1,-1,-1,-1,-1,-1,-1,-1,-1,-1,-1,-1,-1,-1,12,-1,-1,-1,-1,-1,12,-1,12,-1,-1,-1,-1,-1,-1,-1,-1,-1,-1,-1,-1,-1,-1,-1,-1,-1,-1,-1,-1,-1,-1,-1,-1,-1,-1,-1,-1,-1,-1,-1,-1,-1,-1,-1,-1,-1,-1,-1,-1,-1,-1,-1,-1,-1,-1,-1,-1,-1,-1,-1,-1,-1,-1,-1,-1,-1,-1,-1,-1,-1,-1,-1,-1,-1,-1,-1,-1,-1,-1,-1,-1,-1,-1,-1,-1,-1,-1,-1,-1,3,4,4,4,4,4,4,4,5,-1,-1
12,12,12,12,12,4,4,5,-1,-1,-1,-1,-1,-1,-1,-1,-1,-1,-1,-1,-1,-1,-1,-1,-1,-1,-1,-1,-1,-1,-1,-1,-1,-1,-1,-1,-1,-1,-1,-1,-1,-1,-1,-1,-1,-1,-1,-1,-1,-1,12,-1,12,12,12,-1,12,-1,12,-1,-1,-1,-1,-1,-1,-1,-1,-1,-1,-1,-1,-1,-1,-1,-1,-1,-1,-1,-1,-1,-1,-1,-1,-1,-1,-1,-1,-1,-1,-1,-1,-1,-1,-1,-1,-1,-1,-1,-1,-1,-1,-1,-1,-1,-1,-1,-1,-1,-1,-1,-1,-1,-1,-1,-1,-1,-1,-1,-1,-1,-1,-1,-1,-1,-1,-1,-1,-1,-1,-1,-1,-1,-1,-1,-1,-1,-1,-1,-1,3,4,4,4,4,4,4,4,5,-1,-1
12,12,12,12,12,4,4,5,-1,-1,-1,-1,-1,-1,-1,-1,-1,-1,-1,-1,-1,-1,-1,-1,-1,-1,-1,-1,-1,-1,-1,-1,-1,-1,-1,-1,-1,-1,-1,-1,-1,-1,-1,-1,-1,-1,-1,-1,-1,-1,12,12,12,-1,12,-1,12,12,12,-1,-1,-1,-1,-1,-1,-1,-1,-1,-1,-1,-1,-1,-1,-1,-1,-1,-1,-1,-1,-1,-1,-1,-1,-1,-1,-1,-1,-1,-1,-1,-1,-1,-1,-1,-1,-1,-1,-1,-1,-1,-1,-1,-1,-1,-1,-1,-1,-1,-1,-1,-1,-1,-1,-1,-1,-1,-1,-1,-1,-1,-1,-1,-1,-1,-1,-1,-1,-1,-1,-1,-1,-1,-1,-1,-1,-1,-1,-1,-1,3,4,4,4,4,4,4,4,5,-1,-1
4,4,4,4,4,4,4,5,-1,-1,-1,-1,-1,-1,-1,-1,-1,-1,-1,-1,-1,-1,-1,-1,-1,-1,-1,-1,-1,-1,-1,-1,-1,-1,-1,-1,-1,-1,-1,-1,-1,-1,-1,-1,-1,-1,-1,-1,-1,-1,-1,-1,-1,-1,-1,-1,-1,-1,-1,-1,-1,-1,-1,-1,-1,-1,-1,-1,-1,-1,-1,-1,-1,-1,-1,-1,-1,-1,-1,-1,-1,-1,-1,-1,-1,-1,-1,-1,-1,-1,-1,-1,-1,-1,-1,-1,-1,-1,-1,-1,-1,-1,-1,-1,-1,-1,-1,-1,-1,-1,-1,-1,-1,-1,-1,-1,-1,-1,-1,-1,-1,-1,-1,-1,-1,-1,-1,-1,-1,-1,-1,-1,-1,-1,-1,-1,-1,-1,-1,3,4,4,4,4,4,4,4,5,-1,-1
4,4,12,12,12,12,12,5,-1,-1,-1,-1,-1,-1,-1,-1,-1,-1,-1,-1,-1,-1,-1,-1,-1,-1,-1,-1,-1,-1,-1,-1,-1,-1,-1,-1,-1,-1,-1,-1,-1,-1,-1,-1,-1,-1,-1,-1,-1,-1,-1,-1,-1,-1,-1,-1,-1,-1,-1,-1,-1,-1,-1,-1,-1,-1,-1,-1,-1,-1,-1,-1,-1,-1,-1,-1,-1,-1,-1,-1,-1,-1,-1,-1,-1,-1,-1,-1,-1,-1,-1,-1,-1,-1,-1,-1,-1,-1,-1,-1,-1,-1,-1,-1,-1,-1,-1,-1,-1,-1,-1,-1,-1,-1,-1,-1,-1,-1,-1,-1,-1,14,14,14,14,-1,-1,-1,-1,-1,-1,-1,-1,-1,-1,-1,-1,-1,-1,3,4,4,4,4,4,4,4,5,-1,-1
12,4,12,12,12,12,12,5,-1,-1,-1,-1,-1,-1,-1,-1,-1,-1,-1,-1,-1,-1,-1,-1,-1,-1,-1,-1,-1,-1,-1,-1,-1,-1,-1,-1,-1,-1,-1,-1,-1,-1,-1,-1,-1,-1,-1,-1,-1,-1,-1,-1,-1,-1,-1,-1,-1,-1,-1,-1,-1,-1,-1,-1,-1,-1,-1,-1,-1,-1,-1,-1,-1,-1,-1,-1,-1,-1,-1,-1,-1,-1,-1,-1,-1,-1,-1,-1,-1,-1,-1,-1,-1,-1,-1,-1,-1,-1,-1,-1,-1,-1,-1,-1,-1,-1,-1,-1,-1,-1,-1,-1,-1,-1,-1,-1,-1,-1,-1,-1,-1,6,7,7,2,-1,-1,-1,-1,-1,-1,-1,-1,-1,-1,-1,-1,-1,-1,3,4,4,4,4,4,4,4,5,-1,-1
12,4,4,4,4,4,4,5,-1,-1,-1,-1,-1,-1,-1,-1,-1,-1,-1,-1,-1,-1,-1,-1,-1,-1,-1,-1,-1,-1,-1,-1,-1,-1,-1,-1,-1,-1,-1,-1,-1,-1,-1,-1,-1,14,19,-1,-1,16,14,-1,-1,14,16,14,-1,-1,14,19,14,-1,-1,14,17,16,-1,-1,-1,-1,-1,-1,-1,14,14,14,14,-1,-1,-1,-1,-1,-1,17,14,14,14,-1,-1,-1,-1,-1,-1,-1,-1,-1,-1,-1,-1,-1,-1,-1,-1,-1,-1,-1,-1,-1,-1,-1,-1,-1,-1,-1,-1,16,14,14,14,19,-1,-1,-1,-1,-1,-1,-1,-1,-1,-1,-1,-1,-1,-1,-1,-1,-1,-1,-1,3,4,4,4,4,4,4,4,5,-1,-1
12,12,12,12,12,12,12,5,-1,-1,-1,-1,-1,14,16,14,14,14,-1,-1,-1,-1,-1,-1,-1,-1,-1,-1,-1,-1,-1,-1,-1,-1,-1,-1,-1,-1,-1,14,14,16,14,-1,-1,1,2,-1,-1,1,2,-1,-1,1,0,2,-1,-1,1,0,2,-1,-1,1,0,2,-1,-1,-1,-1,-1,-1,-1,1,0,0,2,-1,-1,-1,-1,-1,-1,6,0,0,8,-1,-1,-1,17,-1,-1,-1,-1,-1,-1,-1,-1,-1,-1,-1,-1,-1,-1,-1,-1,-1,-1,14,14,18,14,-1,-1,6,7,7,7,2,-1,-1,-1,19,-1,-1,-1,-1,-1,-1,-1,-1,-1,-1,-1,-1,-1,-1,-1,3,4,4,4,4,4,4,4,5,-1,-1
12,12,12,12,12,12,12,5,-1,-1,-1,-1,-1,1,0,0,0,8,-1,-1,-1,-1,-1,-1,-1,14,14,16,14,-1,-1,-1,-1,-1,-1,-1,-1,-1,14,1,0,0,2,-1,-1,3,5,-1,-1,3,5,-1,-1,3,4,5,-1,-1,3,4,5,-1,-1,3,4,5,-1,-1,14,14,16,14,-1,-1,-1,-1,-1,-1,14,14,16,14,-1,-1,-1,-1,-1,-1,-1,16,-1,-1,-1,-1,-1,-1,-1,-1,-1,-1,-1,-1,-1,-1,-1,-1,-1,-1,-1,6,0,0,2,-1,-1,-1,-1,-1,-1,-1,-1,-1,-1,16,14,14,-1,-1,-1,-1,-1,-1,-1,-1,-1,-1,-1,-1,-1,-1,-1,-1,-1,-1,-1,-1,3,5,-1,-1
12,12,12,12,12,12,12,5,-1,-1,-1,-1,-1,3,4,-1,-1,-1,-1,-1,-1,18,-1,-1,-1,6,7,7,8,-1,-1,-1,-1,-1,-1,-1,-1,16,1,4,4,4,5,-1,-1,3,5,-1,-1,3,5,-1,-1,3,4,5,-1,-1,3,4,5,-1,-1,3,4,5,-1,-1,1,0,0,2,-1,-1,-1,-1,-1,-1,1,0,0,2,-1,-1,-1,-1,-1,-1,1,0,0,2,-1,-1,-1,-1,-1,-1,-1,-1,-1,-1,-1,-1,-1,18,18,16,-1,-1,-1,-1,-1,-1,-1,-1,-1,-1,-1,-1,14,14,14,7,7,2,-1,-1,-1,-1,-1,-1,-1,-1,-1,-1,14,14,16,14,14,14,14,14,-1,-1,3,5,-1,-1
4,4,4,4,4,12,12,5,-1,-1,-1,-1,-1,-1,-1,-1,-1,-1,-1,14,14,14,14,14,-1,-1,-1,-1,-1,-1,14,14,19,-1,-1,-1,-1,1,4,4,4,4,5,-1,-1,3,5,9,9,3,5,9,9,3,4,5,9,9,3,4,5,9,9,3,4,5,-1,-1,-1,-1,-1,-1,-1,-1,-1,-1,-1,-1,-1,-1,-1,-1,-1,-1,-1,-1,-1,-1,-1,-1,-1,-1,-1,18,18,-1,-1,-1,-1,-1,-1,-1,-1,-1,-1,1,0,2,-1,-1,-1,-1,-1,-1,-1,16,18,14,-1,-1,6,7,7,-1,-1,-1,13,17,-1,-1,-1,16,14,17,-1,-1,6,7,7,0,0,0,0,2,-1,-1,3,5,-1,-1
-1,-1,-1,-1,4,4,4,5,-1,-1,-1,-1,-1,14,-1,-1,-1,-1,-1,6,7,7,7,2,-1,-1,-1,-1,-1,-1,6,7,8,-1,-1,14,14,3,4,4,4,4,5,-1,-1,3,5,10,10,3,5,10,10,3,4,5,10,10,3,4,5,10,10,3,4,5,-1,-1,-1,-1,-1,-1,-1,-1,-1,-1,-1,-1,-1,-1,-1,-1,-1,-1,-1,-1,-1,-1,-1,-1,-1,-1,-1,-1,-1,16,-1,-1,-1,-1,-1,-1,-1,1,2,-1,-1,-1,-1,-1,-1,-1,-1,-1,6,7,7,2,-1,-1,-1,-1,-1,-1,-1,6,7,7,2,-1,-1,6,0,0,-1,-1,-1,-1,-1,3,4,4,4,5,-1,-1,3,5,-1,-1
-1,15,-1,-1,-1,-1,-1,-1,-1,-1,14,14,14,2,-1,-1,16,-1,-1,16,-1,-1,-1,-1,-1,-1,-1,-1,-1,-1,-1,-1,-1,-1,-1,6,8,-1,-1,-1,-1,-1,-1,-1,-1,3,5,10,10,10,10,10,10,10,10,10,10,10,10,10,10,10,10,3,4,5,-1,-1,-1,-1,-1,-1,-1,-1,-1,-1,-1,-1,-1,-1,-1,-1,-1,-1,-1,-1,-1,-1,-1,-1,-1,-1,-1,1,0,0,2,-1,-1,-1,-1,-1,-1,-1,-1,-1,-1,-1,-1,-1,-1,-1,-1,-1,-1,-1,-1,-1,-1,-1,-1,-1,-1,-1,-1,-1,-1,-1,-1,-1,-1,-1,3,4,2,-1,-1,-1,-1,3,4,4,4,5,16,-1,-1,-1,-1,-1
14,14,14,14,14,14,14,14,14,14,1,0,0,5,14,14,14,14,-1,14,14,14,14,14,14,14,-1,-1,-1,14,14,14,14,14,14,14,14,14,14,14,14,14,14,14,14,3,5,10,10,3,5,10,10,3,4,5,10,10,3,4,5,10,10,3,4,5,13,-1,-1,-1,-1,-1,-1,-1,-1,-1,-1,-1,-1,-1,-1,-1,-1,-1,-1,-1,-1,-1,-1,-1,-1,-1,14,14,14,14,14,14,-1,-1,14,14,14,14,14,14,14,14,14,-1,-1,-1,16,14,14,14,14,14,-1,-1,-1,14,14,14,14,14,14,16,14,14,14,14,-1,13,14,14,-1,-1,-1,3,4,4,4,5,14,14,14,14,20,-1
0,0,0,0,0,0,0,0,0,0,4,4,4,4,0,0,0,0,-1,6,0,0,0,0,0,8,-1,-1,-1,6,0,0,0,0,0,0,0,0,0,0,0,0,0,0,0,4,5,10,10,3,5,10,10,3,4,5,10,10,3,4,5,10,10,3,4,4,0,0,0,2,-1,-1,-1,-1,-1,-1,-1,-1,-1,-1,-1,-1,-1,-1,-1,-1,-1,-1,-1,-1,-1,-1,0,0,0,0,0,2,9,9,1,0,0,0,0,0,0,0,0,9,9,0,0,0,0,0,0,0,9,9,9,0,0,0,0,0,0,0,0,0,0,0,0,0,0,0,-1,-1,-1,3,4,4,4,4,0,0,0,0,0,0
